AAA	K
AAC	N
AAT	N
AAG	K
ACA	T
ACC	T
ACT	T
ACG	T
ATA	I
ATC	I
ATT	I
ATG	M
AGA	R
AGC	S
AGT	S
AGG	R
CAA	Q
CAC	H
CAT	H
CAG	Q
CCA	P
CCC	P
CCT	P
CCG	P
CTA	L
CTC	L
CTT	L
CTG	L
CGA	R
CGC	R
CGT	R
CGG	R
TAA	X
TAC	Y
TAT	Y
TAG	X
TCA	S
TCC	S
TCT	S
TCG	S
TTA	L
TTC	F
TTT	F
TTG	L
TGA	X
TGC	C
TGT	C
TGG	W
GAA	E
GAC	D
GAT	D
GAG	E
GCA	A
GCC	A
GCT	A
GCG	A
GTA	V
GTC	V
GTT	V
GTG	V
GGA	G
GGC	G
GGT	G
GGG	G
